                                        
 ##########                             
    #           #            ###        
    #   #       #              #        
    #   #       #   ###############     
    ########    #      #    #     #     
    #      #    ########    #######     
    #      #                      #     
    ##########################    #     
    #       #    #    #           #     
    #  $    #   ###   ##########  #     
    #  #    #         #           #     
    #  #    ###########    ########     
       #    #    #         #            
       #    #    #      ####            
       #    #    #      ############    
       #    ###############        #    
       #                           #    
       #############################    
                                        
                                        